NO ./textures/north.xpm
SO ./textures/south.xpm
WE ./textures/west.xpm
EA ./textures/east.xpm

F 40,87,0
C 66,135,245



        1111111111111111111111111
        1000000000110000000000001
101100000111000001000000000000011
100100000000000000010000000000001
111111111011000001110000000000011
100000000011000001110111111111111
111101111111101110000001000000001
111101111111110111010100100000001
110000001101010111000000110000011
100000000000000011000000000000001
100000000000000011010100100000001
11000001110101011111011110N000111
111101111110101111111010000000001
111111111111111111111111111111111
