C 255,255, 255
NO ./textures/north.xpm
SO ./textures/south.xpm
EA ./textures/east.xpm
WE ./textures/west.xpm
F 220,100,0

111111111111111111111111111111111
10000000000100000100000010001   
10000000000100000100000010001   
10000000000100000100000010001   
10000000000000000000000010001   
10000000000100000000000010001   
1000000000010000N000000010001   
10000000000100000000000010001   
10000000000100000100000010001   
111111111111111111111111111111111
